3 3 3 3 3 3 3 3 3 3 3 3 3 3 3 3 3 3 3 3 3 3 3 3 3 3 3 3 3 3 3 3
3 3 3 3 - - - - - - - - - - - - - - - - - - - - - - - - - 3 3 3
3 3 3 - - - - - - - - - - - - - - - - - - - - - - - - - - 3 3 3
3 3 - - - - - - 3 3 3 S 3 3 3 S 3 3 3 3 3 - - - - - 3 - - 3 3 3
3 - - - - - - # 3 3 3 3 3 3 3 3 3 3 3 3 3 3 - - - - 3 - - 3 3 3
3 S - - - 3 # - - 3 3 3 3 3 3 - - - - - - - - - - 3 3 - - 3 3 3
3 3 S - - 3 s - - 3 3 3 3 3 - - - - - - - - - 3 3 3 3 - - 3 3 3
3 3 3 S - 3 3 - - 3 3 3 3 - - - - - - - - - S 3 3 3 3 - - 3 3 3
3 3 3 3 S 3 - - c 3 3 3 - - - - - - - - - 3 3 3 3 3 3 - - 3 3 3
3 3 3 3 3 3 3 3 3 3 3 - - - - - - - - - S 3 3 3 3 3 3 - - - - -
3 - - - - - - - - - - - - - - - - - - 3 3 3 3 3 3 3 3 - - - - -
3 - - - - - - - - - - - - - - - - - S 3 3 3 3 3 3 3 3 s s - c -
3 - - - - - - - - - - - - - - S S 3 3 3 3 3 3 3 3 3 3 3 3 3 3 3
3 - - - - S S - - - - - - - 3 3 3 3 3 3 3 3 3 3 3 3 3 3 3 3 3 3
3 - - 3 3 3 3 3 3 3 3 3 3 3 3 3 3 3 3 3 3 3 3 3 3 3 3 3 3 3 3 3
3 - 3 3 3 - - - - - - - - - - - - - - - - - - - - - 3 3 3 3 3 3
3 - - - - - - - - - - - - - - - - - - - - - - - - - 3 3 3 3 3 3
3 - - - - - - - - - - S - - S - - S - - S - - - - - 3 3 3 3 3 3
3 3 3 3 3 3 3 3 3 3 3 3 3 3 3 3 3 3 3 3 3 3 3 3 - - 3 3 3 3 3 3
3 - - - - - - - - - - - - - - - - - - - - - - - - - # # - - - 3
3 P - S s s s S - - - - 3 3 3 3 - - - - - - - - - - # # - - c 3
3 3 3 3 3 3 3 3 3 3 3 3 3 3 3 3 3 3 3 3 3 3 3 3 3 3 3 3 3 3 3 3
3 3 3 3 3 3 3 3 3 3 3 3 3 3 3 3 3 3 3 3 3 3 3 3 3 3 3 3 3 3 3 3
