9 9 9 9 9 9 9 9 9 9 9 9 9 9 9 9 9 9 9 9 9 9 9 9 9 9 9 9 9 9 9 9
9 - - - - - - 9 - - - - - - - - - - - - - - - - - - - - - - - 9
9 P - - - - - 9 - - - - - - - - - - - - - - - - - - - - - - - 9
9 9 9 ( ( 9 9 9 - - - 9 9 9 9 S 9 9 9 S 9 9 9 9 9 9 9 - - - - 9
9 9 - - - - - 9 - - 9 9 9 9 9 9 9 9 9 9 9 9 9 9 9 9 9 - - - - 9
9 9 - - - S S 9 - - - 9 9 - - - - - - - - - - - - - - - - - - 9
9 9 - - - 9 9 9 9 - - 9 9 - - - - - - - - - - - - - - - S S - 9
9 9 - - - - - 9 - - - 9 9 - - 9 9 9 9 9 9 9 9 9 9 9 9 9 9 9 9 9
9 9 - - - - - 9 - 9 - 9 9 - - 9 9 9 9 9 9 9 9 9 9 9 9 9 9 9 9 9
9 9 - - - - - 9 - - - 9 9 - - 9 9 - - - - - - - - - - - 9 9 9 9
9 9 S S - - - 9 - - 9 9 9 - - 9 9 c - - - - - - - - - - - 9 9 9
9 9 9 9 - - - 9 - c - 9 9 - - 9 9 9 - - 9 9 9 9 9 - - - - - 9 9
9 9 - - - - - 9 - 9 - 9 9 - - 9 9 - - - 9 9 9 9 9 9 - - - - - 9
9 9 - - - - - 9 - - - 9 9 - - 9 9 - - 9 9 9 9 9 9 9 9 - - - - -
9 9 - - - S S 9 9 - - 9 9 - - 9 9 - - - 9 9 9 9 9 9 9 9 - - - -
9 9 c - - 9 9 9 - - - 9 9 - - 9 9 9 - - 9 9 9 9 9 9 9 9 9 - - -
9 9 - - - - - 9 - 9 - 9 9 - - 9 9 - - - 9 9 9 9 9 9 9 9 9 9 9 9
9 9 - - - - - 9 - - - 9 9 - - 9 9 - - 9 9 9 9 9 9 9 9 9 9 9 9 9
9 9 - - - - - 9 - - 9 9 9 - - - - - - - 9 9 9 9 9 9 9 9 9 9 9 9
9 9 - - - - - - - - - 9 9 S - - - - - - 9 9 9 9 9 9 9 9 9 9 9 9
9 9 - - - - - - - - - 9 9 9 - - - - 9 9 9 9 9 9 9 9 9 9 9 9 9 9
9 9 - - - 9 9 9 9 9 9 9 9 9 9 S S 9 9 9 9 9 9 9 9 9 9 9 9 9 9 9
9 9 - - - 9 9 9 9 9 9 9 9 9 9 9 9 9 9 9 9 9 9 9 9 9 9 9 9 9 9 9
